A,B,C,D,E,,Y1,Y2,Y3
0,0,0,0,0,,1,0,0
0,0,0,0,1,,1,0,0
0,0,0,1,0,,1,1,0
0,0,0,1,1,,1,1,0
0,0,1,0,0,,1,0,0
0,0,1,0,1,,1,0,0
0,0,1,1,0,,1,0,0
0,0,1,1,1,,1,0,0
0,1,0,0,0,,0,1,0
0,1,0,0,1,,0,1,1
0,1,0,1,0,,0,1,1
0,1,0,1,1,,0,1,1
0,1,1,0,0,,1,1,0
0,1,1,0,1,,1,1,1
0,1,1,1,0,,1,1,0
0,1,1,1,1,,1,1,0
1,0,0,0,0,,1,0,0
1,0,0,0,1,,1,0,0
1,0,0,1,0,,1,1,0
1,0,0,1,1,,1,1,0
1,0,1,0,0,,1,0,0
1,0,1,0,1,,1,0,0
1,0,1,1,0,,1,1,0
1,0,1,1,1,,1,1,0
1,1,0,0,0,,0,1,0
1,1,0,0,1,,0,1,1
1,1,0,1,0,,0,1,0
1,1,0,1,1,,0,1,0
1,1,1,0,0,,1,1,0
1,1,1,0,1,,1,1,1
1,1,1,1,0,,1,1,1
1,1,1,1,1,,1,1,1
